Appeal_to_Time	Call
Conversation_Killer	Call
Slogans	Call
Red_Herring	Distraction
Straw_Man	Distraction
Whataboutism	Distraction
Appeal_to_Authority	Justification
Appeal_to_Fear-Prejudice	Justification
Appeal_to_Popularity	Justification
Appeal_to_Values	Justification
Flag_Waving	Justification
Exaggeration-Minimisation	Manipulative_Wording
Loaded_Language	Manipulative_Wording
Obfuscation-Vagueness-Confusion	Manipulative_Wording
Repetition	Manipulative_Wording
Appeal_to_Hypocrisy	Reputation
Doubt	Reputation
Guilt_by_Association	Reputation
Name_Calling-Labeling	Reputation
Questioning_the_Reputation	Reputation
Causal_Oversimplification	Simplification
Consequential_Oversimplification	Simplification
False_Dilemma-No_Choice	Simplification
no_technique	no_technique